10 11 5
11111111111
10000000001
10200000201
10000200001
10002300001
10002000001
10000000001
10000000001
10444440001
11111111111