21 177
************************************************************************
*                                  - -                                 *
*                                  - -                                 *
*                                  - -                                 *
*                                  - -                                 *
*                                  - -                                 *
*                                  - -                                 *
*                                  - -                                 *
*----------------------------------- -                                 *
*                                    -                                 *
*-------------------------------------                                 *
*                                                                      *
*                                                                      *
*                                                                      *
*                                                                      *
*                                                                      *
*                                                                      *
*                                                                      *
*                                                                      *
*                                                                      *
************************************************************************
